TTT	F
CTG	L
ATT	I
ATG	M
GTG	v
AGC S
CCG	P
ACC	T
GCG	A
TAT Y
TAA	stop
CAT	H
CAG Q
AAC	N
AAA	K
GAT	D
GAA	E
TGC	C
TGG	W
CGC	R
GGT	G